seats
#L#L#L#L#L#L#L#.L..#L#L#L.#L#L#L#L#.L#L#L#.L#L#L#L.#L#L#L#.L#L#L#.L#L#L#L#L.#L#L...#L#L#L#L#L#
LLLLLL.LLL.LLLLL#L.LLLLLL.LLLLLLLLL.#LLLLLLL.L#LL#.LL.LLLLLL..LLLLLLL.LLLL#.LLLL.#LLLLLLLLLLLL
#L#L#.L#.LL#L#LLLL.#L#L#L#L#.L#L#L#.LL#L#L##.LLLLL.##L#L#L#L.#L#L#L#L.#L#LLL#L##.LL#L#L#L#L#L#
LLLLLL#L.#LLLLL#L#LL.LLLL.LLLLLLLLL.#LLLL.#.L#L#L#.LLLLLLLLL.#LLLLLLL.#LLL#.LLLL.#LLLLLLLLLLLL
.L#L#LLL.LL#L#LLLL.L#L#L#L#L#L#L#L#.LLL#L#LLLLLLLL.##L#L#L#L.LL#L#L#LLLL#LL.##L#LLL#L#L#L#L#L#
#LLLL.L#L#LLLLL#L#.LLLLLLLLLLLLLLLL..#LLLLL#.L.#L#LLLLLLLLLLL#LLLL.LL.#LLL#LLLLL.#LLLLLLLLLLLL
.L#.L#LL..LL#L#LLLL#L#L#L.#L#L#L#.L#LLLL#LLLL.LLLL.#L#L#L#L#.LLL#L#L#LLL#LL.#L.#LLL#L#L#L#L#L#
LLLLLLL#.L#LLLLL#L.L.LLLL.LLLLLLLLL...#LL.##.L.#L#.LLLLLLLLL.##LLLLLL.#LLL#LLLLLL#LLLLLLL.LL.L
#L#.L#L#.LLL#L#LLL.L#L#LL.#L#L.#L#L.#LLL#LLL..#LLL.#L#L#L#L#.LLL#L#L#LLL#.L.L#L#.LLL#L#L#L#LL#
.LLLLLLL.L#LLLLL.#.LLLLL#.LLLL#LL##.LL#LLL##.LLLL#LLLLLLLLLL.##LLLLLL.L..#L#LLLL.##LLLLLLLLLLL
..#......L.L..#.LL.#L....L......#.L.#..L#....L............#..L.L#L..#..LL.LL...............#..
LLLL.#L#.LL#L#LL##.LL#LLL#L#.LL#LL#LLLL#.LLL.L#L#L.L.L#L#.LL.#LLLL#LL.#L#LL.#L#LLLLLL#L#L#LLL#
#L#L#LLL.#LLLLL#LL.#LLL#L.LLL#LLL.L..#LLL##..LLL#L#L#.LLLLL#LLL#L.L#L.LLLL#.LLL.#L##.LLLLLL#LL
LLLLLL#LLLL#L#L.L#.LL#LLL.##LL.#L##.LLL#LLLL.##LLL.LLLL#L#LLL#LLL#LLL.#L#LL.##.L..LLL#L#L#LLL#
#L#L#LLL#L#LLLLLLLL#LLL##.LLL#LLLLL.##.LL#L#.LLLL#L#L#LLLLL#.LL#LLL##.LLLL#.LLL#.LL#LLLLLLL#LL
LL#LLL#L.LLLL#L#.L.LL#L.LL##LLL#LL#.LLL#LLLL.###LLLLLLL#L#LL.#LLL#LL..#L#LL.##L.L#LLL#L#L#LL.#
#L#L#L#L.#L#.LLLL#.L#LLL#.LLL#LLLLLL#L#LL#L#LLL.LL.#L#LLL.L#.L#L.LLL#.LLLL#LLLLL.LL#LLLLLLL.LL
LL.LLLLLLLLLL#L#L..LLL#LL.#L#LL#L##LLLLLLLLL.L#L.#.LLLLL#LLL#L#L###.L#.L#LL.#L#L.LLLL.L#L#L#L#
..L......L....L...#..LLL..L.LL.....L#L.#L.#..LLLLLL...#.L#.LL...L....#..LL#.LLL..L...#........
#L#L#L#L#L#L#L#L.L.LL#L#L.L#L#LL#LL.LL#LLLLL.#L#L#.L#LL#LLL#.#L.LL#LL.LLLLLL#L#L.L#.LL.L#L#L#L
LL#LLLLL.LLL.LLLL#L#L#LLL.#LLLLLLL#.LLLL#L##.LLLLL.LLLLL.#LL.L#L#L#L#L##L##.LLLL#.LL#L#LLL.LL#
#.LL#L#LL#L#L#L#LL.#.LLL#.LLL#L#L.L.#L#LLL#LLL#L#L#LL#L#LLLL.LLLL.LLLLLLLLL.#L#LLLLLLLL#L#L#LL
LL#L#L#L.LLLLLLLLL.LLL#LLLL#L#L#L##.LL#L#L#L#L.LLLL#.LLLL#L#.L.#L#L##.L#.L#.LLLL.#L#L#LLLLLLL#
#L...........L..#.....L..#.....L......L..L.L#.L....LL..#.L...#..LLLL....#L.L#.......LL#......L
LLL#L#L#.L#L#L#LLL#L#L#LLLL.#L#L#LL.L#L#L#L#.LL#LLL#L#LL#L#L.L#.L#L#LL#LLLL..L#L.L#L#LLL#L#L##
#L#LLLLLLLLLLLLL#LLL.LLL#.LLLL.LLL#.LLLLLLLLL#LLL#.LLLLLLLLL.LLLLLLL#.LLL#L#LLLL.LLL#L#LLLLLLL
LLLL.#L#.L#L.#L#LL#LL#L.L..#L.L#LLLL#L#L#L#L.L#L.L.#.L#L#L#L#L#L#L#LL.##LLLL#L#L#L#LLLL#L#L#L#
#L#L#LLL.#LLLLLLLL.LLLL#L#L.L#LLL#LLLLLLLLL.#LLL##.LLLLLLLLL.LLL.LLL#LLLL.#.LLLL.LLLL#LLLLL.LL
LLLLLL#.LLLL#L#L#L.#L#LLL.LL#LL#LL..#L#L#L#..L#LLLL.#LL#L#L#L#L#LL#.L.#L#LL#L#L#..L#LL#L#L#LL#
.L#L#L#L#L#LLLLLLL.LLLLL#L#LLL#LL##L.LLLLLLL.LLL#L#LLLLLLLLL.LLLLLL##.L.LLL.LLLLL#LLLLLLLLL#LL
#LLLLLLL.L.LL#L#L.L##L#L#LLL#L.LLLL..#L#L#.#L#LLLL.L#L##LL#L.#L#L#LLL#.L#L#.L#L#L.LL#L#L#LLLL#
L.#..L#LL..#...L.#..L..L.L#.L..#....LL.L...L..L.#.L#......LLL.L.L..#.......L...L#...LLLL....L.
#L.L#LLL.#LLLL#L#LLL#LL#L.LLL#LLL#L.#L#L#L#L#L#LL#.LLL.LL.#..LLLLLLLLLL#.LLL#L#L.LL#L#L#L#L#LL
.LLLLL#L#LL#L#LLLL..LLL#L#L#L#L#LLL.LLLLLLLL.LLLLL.#L#LL#LL..#L#L#L#L#L.LL#LLLLLL.LLLLLLLLLLL#
LL#L#LLL.L#LLLL#L#LLL#LLLLLLLLLLL#L#L#L#L.#L.#LL##.LLLLLLL#.LL..LLLLLLLL#.L.L#L#L#L#L#L#L#L#LL
#LLLLL#L..LL#L#LLL.#LL.#L.L#L#L#LLL.LLLLLLLL.LL.LL.#L#L#LLLL.L#LL#L#L.#LLL#.LLL#.LLLLLLLLLLLL#
LL#L#L#LL##LLLLL#..LL#LLL..LLLLLL#L.#L#L#L#L..L#L#..L#L#L#L#.L.LLLL#L.L.#LL#L#LL.L#L#L#L#L#LLL
#.LL...LL..L......#..L..#..L.L#...LL...L....L#..L..........L..L.#.LL.#......L.........L.L.L...
LL#LL#L#.LLLL#L#L#.L#L#LL.#L#LLL#L#.L#L#L#L#LLLLLL#L#L.L#L#L.L#L#L#LL.L#LL#L.L#L.#L#L#L#L#L#L#
#LLLLLLL.#L#LLLLLL.LLLLL#.LLLL#L#LL.#LLLLLLLL#L##L#L#L#LLLL#.LLLL.LL#LLL#L#L#LLL.LLLLLLLL.LLLL
LL#L#L#LLLLLL#L#L.LL#.LLLL#L#LLLLL..LL.#L#.LLLLLLLLLLLLLL#LL.#L#.L.LL.#LLLLLLL#L.##L#L#L#LL#L#
#LLLLLL..#L#LLLLL#.LLL.#L.LLLL#L#LL.#L#.LLL#.L#LL#L#L#L#LLL#LLLL#L#L#.LL#LL.#L.#.LLLL.LLL#LLLL
LL#L#L##LLLLL#L#LL.#L#LLL.#L#LLLLL.LLLLL#L#..LLLLL.LLLLLL#LL.L#LLLLLL.#.LL#.LLLL.#L#L#L#LLL#L#
#LLLLLLL.#L#LLLLL#LLLLL...LLLL#L#L#.L#L#LLLL#L#L#L.#L#L#LLL..LLL.L#L#LLL#LL.#L#.LLLLLLLLL#LLLL
LL#L#.L#.LLLL#L#LL.#L#L#L.#L#LLLLLL.#LLLL##L.LLLL#LLLLL#L#L#.LLL#LLL.L#LLL#LLLLL#L#L#L#LLLL#L#
#LLLLLLLL#.LLLLLL#.LLLLLLL#LLLL.L#L#LLL#L.LL.#L#LL.#L#L.LLLL#L#.LL#LLL#LLLL.#LLL.LLLLL.L#LLLLL
LLL#L#L#.LL#L#L#LL.##L#L#.LL##L#LLL.L#LLLL##LLL#.L.#LLL.#L#..LL.#L#L#L#L#L..#L#LL#L#L#LL#L#L#L
.#.L..LL....L.LLL#.....LL.#...L.L..#L..L#........L#..L.L..L....L.LLL....L..L.L..#.LL..L.....L.
LLLL#L#L#LLLLL#L#L.LLLL#L.LL##L#L#L.LL#LLL#L#L.LL.#L#L##L#LL.##LLLL#L.L#L#..L#LL.L#L#L.#LLL.L#
#L#L#LLL.#L#LL.L.L.#L#L#L.#LLLLLLLL.#L#L#L##.LL#L#LLLLLLLLL#LLLL#L#LL.L#LLL.#L.#.LLLLLLLL.L#LL
LLLLLL#L.LLLL#L#L#L#LLLLL.LL#L#L#L#.LL#LLLLL.#LLLL.L#LL#L#LLL#L#L.#L#.LLLL#.LLLL.L#L##L#L#LL.#
#L#L#LLL.#L#LLLLLLL.#L#LL#LLLLLLLLL.#LLL#L##.LL#L##LLL#LLLL#.LLLL.LLL.L#L#L.#L#..LLLLLLLLLL#LL
LLLLLL#L.LLLL#L#L#.LLL.L.L#L#L#L#L#LLL#LLLLL.#LLLLLL#LL.#L#L.#L#L#L#L#LLLLL.LLLLLL#L#L.#L#LLL#
#L#L#LLLL#L#LLLLLL.L#LLL#.LLLLLLLLL.#LLLL#L#.LL##L.#.L#LLLLLLLLLLL.LLLL#L#L.L#.L#.LLLLLLLLL#LL
LLLLL.#L.LLL#L#L#L#LLL#LLLL#L#L#L#L.L#L#LLLL.#LLLL.LLLLL#L#L#L#L#L#L#.LLLLL#LLLL.L#L#L#LL#LLL#
#L.L#..L.#L.....LL..L.LLL#..........L.....#.L..#L..L#L#....L.........L.#...L...L....L...LL...L
LL#LLLLL.LL#LLLLL..#LLL#..LL#L#L#L#.LLLLLLLL.LLLL#LLLLLLLLLLL#LLLLLLL.L#L##..L##..L#L#L#L#LLL#
#LLL#L#L##LLL#L#L#.LL#LLL.#L#L#L#.L.L#LL#L#L#L#LLL.#L#L#L#L#.LLL#L#L#.LLLLL.#L.L.#.LL#LLLLL#LL
LL#LLLLLL.L#LLLLLL.#LLL#LL#L.LLLLLL.LL#LLL#..LLL#LLLLLLLLLLL.L#LLLLLL.L#L##.LLL#LLL#.LL#L#LLL#
#.L#L#L#.LL#L.#L#L.LL#LL#.L#L#L#L#L.#L.L#LL#.#LLLL.#L#L#L#L#.LLL.#L#.LLLL.L#L#LL.#LLL#L#LLL#LL
....L........L.....#.L.............L.L..L..LLLL.......L......L#.........L....#...L.#L..LL.#L.#
LLLL#L#L.LLL#LLLL#LLL#LLL.LL#L#L#L#.L#L##L#L.##L##.L#L#L#LLL..LL#L#L#.L##L#.LLLL.#LLLL#LLLL.LL
#L#LLLLL.L#LLLL#.L.#L#L#L.#LLLLLLLL.LLLLLLLL.LLLLL.#LLLLLLL#.L.LLLLLLLLLLLL.##L#.LLL#LLL#L#.L#
LLLL#L#L#LL#L#LL.#.LLLL#L..#L#L##L#.L#LL#L#L.#LL##.LL#L#L#L..L#L#L#L#.L#L##.LLL.LL#LLL#LLLLLLL
#L#L.LLL.#.LLL#LLL.#L#LL.LLLLLLLLLL.LL#LLLLL.LLLLL.#LLLLL#LLLLLLLLLLL.LLLLL.##LL.LLL#LLLL#L#L#
LLL#L#L#.LLL#LLL#L.LLL#L#.L#L#LL#L#L#LLL#L#L.##L#L.LL#L#.LL#L#L#L#LL#.L#L#L.LLLL#L#L#LL#LLLLLL
.L..LL.LL...LL#..L..#..L.L..LL......LL#L......L...L#L...L..L...#L....LL....L#.L#LLL...L.L.L..#
#L#L#L#L.#L#.LLLL#.LLL.#L.#.L#L#L#L.#LLLL#L.LL.LL#LLLL#L#LL#.L#LLL#LL#L.#L#.LLLL.#L#L#LLL#L#L.
LL.LLL.#...LL#L#.L.#L#L.L.LLLLLLLLLLLLL#LLLL#L#LLL.##LLLLLLL.#.L#LLL#LLL#LL.L#LLLLLLLLL#LLL#LL
#LL#L#LL.L#LL.LL.#.LLLLLL.#L#L#L#L#.L#LLLL#L.LLL##.LLL#L.#LLLL.#L.#LLL#L.L#LLLL.L#L#LL#LL#.LL#
LL.LLL#L#LLL#L#LLL#L#L#L#LLLLLLLLLL.LLL#L.LLLL#LLL.#LLLLLLL#LLLLLLLL#.LLLLL.LL##.LLLL#..LLL#LL
#L#L#LLL..#LLLLL#..LLLL.L.#L#L#LL#LL.#LLL##L#LLL#LLLL#L#L#LL.L#L#L#LL.L.#L#..LLL.#L#L#L#LLLLL.
LLLLLL#..LLL#L#LLL.#L#L#L.LLLLLLLLL#LLL#LLLLLL#L#L#LLLLLLLL##LLLLLLL#LLLLLL.#L#L.LLLL.LLL#L#L#
#L#L#LL..#LLLL.L#L.LLLLLL.LL#L#L#LL..#LL#L#L#LLLLL.L#L#LL#LLLL#L#L#LLL#L#L#.LLL.LL#L#L##.LLLLL
LLLLL.#LLLL#LLLLLL.#LL#L#L#LLLLLLL#LLL#LLLLLLL#L#L.LLLLL#LL#.LLLLLLL#.LLLLL..#L#.LLLLLLLL#L#L#
#L#L#LLL#LLLL##L#L.L#.LLLLLLL.#L#LL.#.LL#L#L#LLLL..L#L#L.L#L.L#L#L#LL.L#L#L#L#L#.L#L#L#LLLL.LL
.....LLL..#..L...LL..L.#L.#L#L....#.L.#L.L.L......L#LL..L..L#.L......L.LL.....L...#...L..#L#..
.#L#L#L#.LLL##LLL#LLL#L.L.LLLLL#LLL.#LLLL#L#L.LL##.LL#L#L#L#.LL#LL.#L.#L#LL.#L##.LLLLLL#LLLLL#
LLL#.LLL.LL.LLL#LL.#LLLLL#L#L#LLLL#LLLL#LL.L.##L.L.#LLLLLLLLL#LLLLLLL.LLLL#LLLLL.#L#L#LLL#L#LL
#LLLLL#L.#L#L#LLL#LLL#L#L.LLLLLL#LLL#L.L#L#LLLLLL#.LL#L#L#L#LLLL#L#L#L#L#LLL#L#L.LLLLLL#LLLLL#
LL#LLLLL.LLLLLL#L..#LLLLL.LL#L#LLL#.LL#LLLLLL#L.LL.L#LLLLLLLL#L#LLLLLLL.LL#.LLLL#.L#L#LLL#L#LL
#LLL#L#L.#L#L#.LLL.LLL#L#L#LLLLL#.L.#LLL#L##.L.#L#LLL.#L#L##.LLLL#L#L#L#LLL.L#L#.LLLLLL#LLLLL#
LL#LLLLL.LLLLLLL#.LL#LLLLLLL#L#LLL#.LL#LLLLL.#LLLLL##LLLLLLLL#L#LLLLL.LL.#L.LL.#L#L#L#LLL#L.LL
#LLL#L#L.L#L#L#LLL#.LL#L#L#LLLLL#LL.#LLL#LL#.L#L#L.LLL#L#L#L.LLLLL#L#.L#LLL.L.LL.LLLLLL#LLL#L#
L.#.L.......L.LL#.L.#..L.LLL.#..L...LL#L.#.L.....L...#..L........#...LL...#..L...L#L#..L..L...
#LLLLLLLL#L#L#LLL#LLLLLLL.#LLLL#LLL.#LLLLLLL.LLLL#.#LLLLL#LL.#LLLLLL..#L#LLL##L#LLL.LLL#L..LLL
LL#L#LL#.LL#LLL#LL.#L#LL#.L#L#LL#L#.LL#L#L#L.#L#LLLLL#L#L#L#.LL#L#L#LLL.#L#..LLL.#L#L#LL.#L#L#
#LLLL.LL.#LLL.LL.#.LLL.LL.LLLL.LLLL.#LLLLLLL.LLLL#.L#LLLL.LL.#LLLLLLL#LLLLL.L#L#LLLLLLL#LLLLLL
LL#L#L#LLLL#L#L#L.L#L#L#L.L#L#L#L#LLLL#L#L#L.#L#LL.LLL#L#L#L.LL#L#L.#.L#L#LLLLLL.#L#L#LLL#L#L#
#LLLLLLL.#LLLLLLLL.LLLLLL#LLLLLLLLL.#LLLLLLL.LLLL#.L#LLLLLLL#LLLLLLLL.#LL.L.##L#.LLLLLL#LLLLLL
.L#L#L.#.L#L#L#L#L#L.#L#LLL#L#L#L#LLLL#L#L#L.#L#LL.L.L#L#L#LL.#L#L#L#.L.#L#.LLLLLL#L#L#.L#L#L#
LLLLLLLL.LLLLLLLLL.LLLLLL#LLLLLLLLL.#LLLLLLL.LLLL#LL.LLLLLLL.LLLLLLLLLLLLLL.#LL#.LLLL.LLLLLLLL
#L#L#L#L..#L#L#L#L.#L#L#..L#.L#L#L#.L#L#L.#L#L.#L#L#L#L#L#L#L#L#L#L#L.#L#L#..L#L.#L#L#L#L#L#L#
